# Shortcuts

|Keys|Action|
|--|--|
|Shift + Click	|Select node|
|Shift + area	|Select node area|
|Delete	|Delete node|
|Ctrl + dia21	|Align left|
|Ctrl + dia24	|Align right|
|Ctrl + dia23	|Align bottom edge|
|Ctrl + dia22	|Align top edge|
|Ctrl + F	|Search node|
|Ctrl + F (in dock)	|Search/ change key|
|Ctrl + S	|Save current model|
|Ctrl + H	|Focus on original node|
|Ctrl + R	|Evaluate node|
|Ctrl + Y	|See node ID|
|Ctrl + Click	|Insert node in other nodeâ€™s definition|
|Ctrl + espacio	|Autofill|
|Ctrl + B	|Edit node number format|
|Ctrl + C	|Copy node|
|Ctrl + X	|Cut node|
|Ctrl + V	|Paste node|
|Ctrl + M	|Create alias|
|Ctrl + D	|Duplicate node|
|Ctrl + G	|Same height|
|Ctrl + I	|Same width|
|Ctrl + Alt + 0	|Same size|
|Ctrl + E	|Quick evaluate of nodes|
|Ctrl + A	|Select all items from PivotGrid and influence diagram|
|Ctrl + Alt + O	|New output|
|Ctrl + Alt + I	|New input|
|Ctrl + Alt + D	|Go to influence diagram|
|Mouse Wheel	|Move the diagram up/down|
|Alt + Mouse Wheel	|Move the diagram left/right|
|Ctrl + Mouse Wheel	|Increase/reduce node size|
|Ctrl + Shift + H	|Go back to the last level when navigating the modules in the diagram|
|Ctrl + Q	| Go one level up|
|Ctrl + Shift + C	|Copy PivotGrid with format|

<!--stackedit_data:
eyJoaXN0b3J5IjpbLTE1NTYzNzY3MTEsMTA1NjQ4Njc3OV19
-->